GGGGGGGGGGGGGGGGGGGGGGGGGGGGGGGGGGGGGGGGGGGGGGGGGGGGGGGGGGGG
GGGGGGGGGGGGGHGGGGGGGGGGGGGGGCVGGGGGGGGGGGGGGHGGGGGGGGGGGGGG
GGGGGGGGGGGGGGGGGGGGGGGGGGGGGGGGGGGGGGGGGGGGGGGGGGGGGGGGGGGG
GG2DDDDDDDDDDDDDDDDDDDDDDDSDDDDDDDDDDDDDDDDDDDDDDDDDDDDDDD3G
GGPGGGGGGGGGGGGGGGGGGGGGGGGGGGGGGGGGGGGGGGGGGGGGGGGGGGGGGGPG
GGPGGGGGGGGGGGGGGGGGGGTGGGGGGGGGZXGGGGGGGGGGGGTGGGGGGGGGGGPG
GGPGGGGGGGGGGGGGGGGGGGGGGGGGGGGGGGGGGGGGGGGGGGGGGGGGGGGGGGPG
GGPGGGGGGGGG2DDDDDDDDDDDDDDDDDDD3GGG2DDDDDDDDDDDDDDD3GGGGGPG
GGPGGGGGGGGGPGGGGGGGGGGGGGGGGGGGPGGGPGGGGGGGGGGGGGGGPGGGGGPG
GGPGGGGGGGGGPGGGGGGGZXGGGGGGGGGGPGGGPGGGGGGGGCVGGGGGPGGGGGPG
GGPGGGGGGGGGPGGGGGGGGGGGGGGGGGGGPGGGPGGGGGGGGGGGGGGGPGGGGGPG
GGPGGGGGGGGGPGGGGGGGGGGGGGGGGGGGPGGGPGGG2DDDDDDDD3GGPGGGGGPG
GG1DDDDD3GGGPGGGGGGGGGTGGGGGGGGGPGGGPGGGPGGGGGGGGPGGPGGGGGPG
GGGGGGGGPGGGPGGGGGGGGGGGGGGGGGGGPGGGPGGGPGGGGGGGGPGGPGGGGGPG
GGGGGGGGPGGGPGGGGGGGGGGGGGGGGGGGPGGGPGGGPGGGGGGGG3DD2GGGGGPG
GGGGGGGGPGGGPGGGGGGGGGGGGGGGGGGGPGGGPGGGPGGGGGGGGGGGGGGGGGPG
GGGGGGGGPGGGPGGGG2DDDDDDDDDDDDDD4GGGPGGGPGGGGGGGGGGGGGGGGGPG
GGGGGGGGPGGGPGGGGPGGGGGGGGGGGGGGGGGGPGGGPGGGGGGGGGGGGGGGGGPG
GGGGGGGGPGGGPGGGGPGGGGGGGGGGGGGGGGGGPGGGPGGGGGGGGGGGGGGGGGPG
GGGGGGGGPGGGPGGGGPGGGGGGGGGGGGGGGGGGPGGGPGGGGGGGGGGGGGGGGGPG
GGGGGGGGPGGGPGGGGPGGGGGGGGGGGGGGGGGGPGGGPGGGGGGGGGGGGGGGGGPG
GGGGGGGGPGGGPGGGG1DDDDDDDDDDDDDDDDDD4GGG1DDDDDDDDDDDD3GGGGPG
GGGGGGGGPGGGPGGGGGGGGGGGGGGGGGGGGGGGGGGGGGGGGGGGGGGGGPGGGGPG
GGGGGGGGPGGG1DDD3GGGGGGGGGGZXGGGGGGGGGGGGGGGGGGGGGGGGPGGGGPG
GGGGGGGGPGGGGGGGPGGGGGGGGGGGGGGGGGGGGGGGGGGGGGGGGGGGGPGGGGPG
GGGGGGGGPGGGGGGGPGGGGGGGGGGGGGGGGGG2DDDDDDDDDDDDDDDDD4GGGGPG
GGGGGGGGPGGGGGGGPGGGGGGGGGGGGGGGGGGPGGGGGGGGGGGGGGGGGGGGGGPG
GGGGGGGGPGGGGGGGPGGGGGGGGGGGGGGGGGGPGGGGGGGGGGGGGGGGGGGGGGPG
GGGGGGGGPGGGGGGGPGGGGGGGGGGGGGGGGGGPGGGGGGGGGGGGGGGGGGGGGGPG
GGGGGGGGPGGGGGGGPGGGGGGGTGGGGGGGGGGPGGGGGGGGGGCVGGGGGGGGGGPG
GGGGGGGGPGGGGGGGPGGGGGGGGGGGGGGGGGGPGGGGGGGGGGGGGGGGGGGGGGPG
GGGGGGGG1DDDDDDD4GGGGGGGGGGGGGGGGGG1DDDDDDDDDDDDDDDDDDDDDD4G
GGGGGGGGGGGGGGGGGGGGGGGGGGGGGGGGGGGGGGGGGGGGGGGGGGGGGGGGGGGG
